************************
*......................*
*......................*
***********............*
*...................****
*......................*
*......................*
*.............*****....*
*.............**.......*
*......................*
*......................*
*......................*
*......**............***
*....****..........*****
*......................*
*......................*
*......................*
***...........**......**
******........**......**
******...............***
*******...............**
*******...............**
**********............**
************************
